1111111111111111111111111111111111
1E000000000C000C00C00C000C00000001
101001010010000010100100000C010101
101001001010101000100100C00C010101
1P00C0000C00C000000000C0000C0000C1
1111111111111111111111111111111111
