11111111111111111
1ECCCCCCC1CCCCCC1
1CCCCCCCC1CCCC1C1
1PCCCCCCC1CCCC1C1
1111111CCCCC11111
11111111CCC111111
11111111111111111
