11111111111111
1C0100011101E1
10000100000001
10100110011111
11001100101011
111011100000C1
100C00C0011111
10110P1C000001
10001011100101
101010101101C1
100C10C00001E1
11111111111111
