1111111
1CECCC1
1110011
11C1C11
1EECPC1
1111111
